name,average_twitter,average_reddit,twitter,posts,comments,total
Donald Trump,0.024115297970799605,-0.028955508830950563,1018573,594,29131,1048298
Joe Biden,0.1268472644123195,0.07472701501382831,509927,277,9847,520051
Jeff Bezos,0.3240486604361359,0.027181481481481466,1605,0,54,1659
Elon Musk,0.09670256933115555,-0.11332433679354101,36780,8,859,37647
Jeremy Blackburn,0,0,0,0,0,0
Mike Pence,0.09689392546495812,0.012785137614678902,14141,3,542,14686
Anthony Fauci,-0.0656601724137928,0.10973260188087763,4060,7,312,4379
Kamala Harris,0.15867700024289827,0.13579109357384447,82340,9,878,83227
Vladimir Putin,-0.006589654729816655,-0.06944396551724137,7791,1,231,8023
Boris Johnson,0.022186569213374266,0.14579583333333335,12382,0,24,12406
Kanye West,0.052167997718198036,0.05805263157894736,8765,0,57,8822
Adolf Hitler,-0.08426738918655578,-0.0979566945606695,4106,1,477,4584
Mao Zedong,0.3169252205978767,0.4270476523476527,83523,1,1000,84524
Joseph Stalin,0.05565082706766905,-0.09420615384615383,1995,0,65,2060
Jesus Christ,0.12897163004263604,0.041332240437158475,3049,2,181,3232
Hillary Clinton,0.09008785704365184,-0.026662386156648475,21601,5,1093,22699
Jeffrey Epstein,-0.05996253662620296,-0.0993838028169014,2389,1,141,2531
Andrew Yang,0.22075594189741296,0.3193571428571426,22030,1,181,22212
Mitch Mcconell,0.04990076161083021,-0.012083770076077761,20089,15,1168,21272
Mark Zuckerberg,0.004325839616175404,-0.03727297297297298,1459,0,37,1496
Tom Cruise,0.09275478260869567,-0.01564000000000002,115,0,5,120
Bernie Sanders,0.17540178849857796,0.15760398899587344,21806,19,708,22533
